603,92,634,87,644,111,675,100,677,70,723,62,734,82,733,110,765,111,772,90,785,85,890,105,900,165,885,165,854,217,811,231,790,313,750,332,660,320,660,290,626,273,606,220,616,183,600,137,610,111

603,92,677,60,890,110,750,327,625,270

========

654,410,616,400,540,400,490,430,464,420,500,300,515,230,600,210,625,277,660,317

++++

505,456,547,460,580,433,620,432,650,437,685,442,703,426,737,417,803,379,814,314,860,280,830,268,750,333,650,234,660,412,577,398,503,428


463,420,447,525,516,510,523,575,622,572,630,545,680,470,720,467,708,428,688,443,636,437,583,437,524,464,495,448,500,427

720,468,744,468,740,490,830,492,930,440,880,593,863,598,864,618,899,633,760,760,660,674

863,282,903,285,905,386,961,416,933,442,847,481,759,479,746,468,721,468,715,428,799,387,823,310,859,291

525,573,467,634,524,695,564,682,561,720,589,774,568,783,585,813,606,803,613,833,626,835,633,808,660,837,670,909,752,761,666,669,718,471,681,469,606,569
